48 24 40 61 20 27 28 45 22 29 70 45 81 43 67 67 48 23 39 34 46 60 47 67 70 34 32 57 31 25 38 67 54 62 21 48 60 67 65 47 44 40 26 58 46 21 85 46 34 36 52 29 65 34 44 33 55 26 41 34 11 50 81 67 64 45 24 62 23 40 28 70 67 33 30 35 44 39 28 69 65 38 74 59 21 46 53 61 41 57 62 43 7 62 46 38 65 60 61
37 26 78 60 76 94 55 40 60 48 52 38 32 32 13 66 61 32 28 70 35 36 53 41 56 56 76 69 39 17 42 28 41 58 79 52 33 40 37 24 62 67 52 51 50 33 29 24 32 27 45 29 68 51 29 30 41 65 52 49 62 96 40 69 57 37 34 51 38 48 24 69 63 29 49 29 31 45 25 17 30 47 29 65 65 34 73 45 19 57 18 83 67 13 31 67 28 35 60
53 13 41 21 64 40 41 63 67 72 59 63 58 39 47 20 28 29 33 25 23 64 54 53 52 48 37 39 65 55 27 45 29 31 37 24 34 30 54 37 23 56 36 54 43 52 29 54 40 76 71 48 14 41 19 21 54 22 35 42 65 38 36 45 10 33 52 64 40 20 25 42 46 47 14 27 33 51 55 30 56 27 37 63 23 47 26 49 28 25 77 54 27 46 45 30 18 40 75
43 22 53 75 56 39 43 45 30 72 96 64 16 62 66 32 48 52 51 51 17 42 31 73 68 32 37 52 14 45 72 58 52 14 51 60 34 50 43 23 85 33 34 46 67 57 50 67 68 36 32 37 53 24 65 56 56 54 50 51 61 50 53 82 43 30 33 34 42 53 14 57 61 69 36 33 38 74 66 39 84 46 35 47 28 38 21 45 11 50 66 53 65 49 77 56 47 38 57
45 14 47 32 63 51 52 50 79 41 72 24 29 41 31 19 41 25 33 59 60 34 73 64 26 26 43 42 58 57 51 30 56 45 44 84 39 57 32 33 64 59 42 27 28 24 58 76 70 55 34 36 22 8 16 44 72 41 61 79 64 15 58 61 28 10 22 19 54 61 29 34 39 54 68 31 35 58 38 40 72 38 43 66 52 19 28 67 86 50 26 61 65 36 74 46 27 53 65
57 75 72 58 51 94 75 41 57 66 45 33 23 36 55 40 45 35 68 31 66 56 28 45 40 70 29 59 38 69 41 38 46 34 33 29 47 45 36 20 39 62 29 37 36 64 42 39 54 31 15 58 54 57 25 28 62 29 44 20 32 50 38 50 85 68 39 22 23 45 58 70 34 67 63 53 44 19 55 67 66 77 30 25 33 56 72 61 50 89 66 72 52 21 28 62 49 20 37
50 60 51 37 49 13 28 63 67 83 68 57 33 21 23 24 61 62 18 48 38 35 35 68 17 59 78 35 61 68 21 69 42 32 54 15 40 42 68 51 49 36 28 16 18 34 38 83 39 73 48 31 33 45 48 40 33 46 48 52 42 47 59 35 45 53 18 44 56 5 67 67 50 54 52 41 23 26 37 73 59 31 82 81 59 15 46 74 36 30 29 32 46 67 78 53 40 37 60
70 28 62 63 60 47 69 69 61 35 79 62 68 57 50 52 44 36 50 16 42 47 40 13 39 27 28 49 18 20 55 45 27 45 65 29 69 45 13 21 69 36 41 40 44 59 68 54 13 66 64 47 40 52 56 43 25 23 45 40 10 62 75 65 66 45 13 12 29 63 61 43 40 83 39 51 40 26 53 41 56 14 41 20 34 67 16 81 63 52 52 53 41 30 47 79 56 62 82
41 50 14 46 12 58 56 54 59 66 30 75 42 68 59 64 62 68 33 45 69 35 57 78 59 31 57 43 61 21 56 56 73 51 52 48 48 41 54 30 53 44 52 41 29 59 19 44 47 53 27 72 33 27 59 23 30 49 43 24 43 55 37 24 43 58 61 48 70 67 52 71 40 48 49 49 47 41 50 24 26 24 33 49 37 51 62 46 44 32 58 34 20 22 39 51 36 29 14
36 53 39 63 51 67 28 69 29 62 45 62 52 41 34 37 28 74 19 58 41 39 43 68 51 41 45 33 20 20 43 37 34 8 44 36 15 21 51 28 38 41 18 47 29 41 48 40 47 73 58 57 30 35 55 37 55 51 61 76 46 36 43 50 49 60 18 64 11 49 77 86 46 43 51 52 34 41 61 74 45 33 39 67 54 51 63 20 30 43 40 51 62 54 49 55 52 52 46
53 46 50 38 40 21 72 49 46 34 50 44 54 44 40 61 58 66 98 73 23 51 52 23 40 35 21 25 87 57 26 61 56 46 30 62 42 31 46 26 33 23 46 58 30 43 26 45 67 68 44 58 45 53 35 17 76 59 37 49 50 34 31 38 41 22 42 9 36 42 39 40 62 79 40 50 51 26 47 54 84 66 39 47 45 38 27 31 61 54 62 59 78 26 48 42 32 43 39
45 40 60 40 51 33 36 52 41 65 15 41 44 40 38 56 19 25 60 56 57 50 15 14 33 46 35 62 75 22 51 36 41 20 47 30 33 51 32 66 55 54 66 63 50 29 18 27 55 62 84 54 51 32 49 40 36 39 46 71 61 21 69 69 31 52 20 42 26 27 49 45 56 33 50 48 40 48 20 59 66 49 35 50 66 35 31 39 45 34 39 57 82 59 32 18 63 59 56
23 20 33 68 25 55 33 43 63 57 59 66 44 79 40 54 24 37 64 60 38 47 73 28 19 35 51 52 14 38 34 77 54 73 46 36 49 42 57 61 54 28 31 26 50 11 27 27 20 28 32 29 59 62 46 67 71 48 22 84 51 46 23 33 60 59 44 43 41 65 58 48 31 47 16 56 44 47 62 58 32 40 47 25 54 67 52 55 56 43 27 61 28 67 47 18 58 38 61
55 42 16 57 20 57 43 53 60 52 42 18 22 37 50 28 63 18 27 45 37 71 68 11 46 50 53 76 82 53 37 47 40 94 64 45 78 27 26 22 50 24 37 69 72 30 37 68 28 62 40 49 34 38 68 51 44 65 68 24 31 40 30 52 31 55 59 33 38 16 54 47 50 49 21 27 39 31 39 9 35 41 60 37 43 26 40 77 10 34 39 48 45 21 41 45 59 53 55
41 25 32 37 21 31 54 48 68 26 67 34 48 81 32 67 71 81 21 24 25 53 34 25 58 48 9 33 25 19 59 36 56 10 39 19 45 38 61 54 41 42 27 44 70 43 76 29 30 66 55 12 60 89 78 29 45 63 81 59 59 47 44 12 47 30 55 36 50 70 49 59 53 58 49 14 25 63 76 60 53 48 41 54 56 32 39 33 39 44 25 53 34 49 8 57 44 53 61
41 40 47 61 52 62 39 64 19 42 55 54 76 78 57 45 65 53 80 47 43 62 61 25 26 66 54 62 43 35 37 45 52 50 59 23 51 66 14 31 25 25 37 39 72 53 32 51 68 42 42 48 72 52 37 49 44 59 36 31 43 53 15 36 64 63 41 54 52 73 75 75 47 40 35 34 59 57 41 45 54 52 25 30 71 71 58 53 52 60 50 32 25 41 96 39 40 46 36
34 58 49 70 58 23 45 44 69 61 5 57 37 24 43 52 79 40 5 38 27 43 46 36 49 77 23 27 50 42 31 58 34 27 51 48 36 29 52 77 51 49 36 52 71 38 5 40 50 43 59 54 50 59 53 45 47 73 56 37 17 47 56 18 57 35 38 38 26 26 49 55 38 28 47 20 48 31 42 71 74 75 56 37 55 76 28 43 45 59 64 47 26 58 29 40 76 72 65
71 32 55 23 48 49 60 48 79 71 33 35 37 23 47 53 48 77 65 70 34 56 87 74 73 35 50 54 56 47 35 25 47 45 32 41 18 29 27 84 63 65 41 4 39 11 43 72 53 14 49 17 65 7 69 42 29 65 27 66 70 35 66 45 35 24 27 16 69 76 51 45 27 30 52 45 31 37 22 38 55 80 22 28 64 26 73 94 21 29 74 46 60 53 56 82 37 37 61
43 46 50 17 35 40 28 37 36 58 73 55 52 39 60 63 32 58 72 35 15 52 16 41 33 52 31 51 45 30 15 17 75 80 50 46 62 76 58 51 33 64 48 25 43 64 73 50 25 51 90 67 7 52 43 39 68 36 37 67 23 17 59 24 56 65 56 42 55 75 86 27 29 28 47 49 11 71 75 63 62 39 34 56 57 47 30 57 46 19 54 44 41 39 33 36 20 20 60
47 40 66 17 49 66 81 77 5 64 45 74 68 67 46 51 41 60 48 39 25 29 52 47 59 70 31 46 40 46 56 68 38 44 51 53 38 48 22 45 24 36 57 73 58 47 63 38 34 61 54 49 63 56 44 71 78 42 7 36 19 54 48 59 38 20 34 50 39 31 58 57 38 36 56 53 44 33 65 49 67 60 57 41 49 54 61 54 33 61 33 27 19 49 42 76 51 73 80
68 37 63 51 40 41 32 56 33 41 33 35 56 62 68 28 58 64 48 43 21 25 49 18 40 21 30 45 64 20 46 46 29 43 20 71 55 29 50 42 66 64 40 65 27 55 28 22 29 9 47 30 46 43 57 38 20 19 70 68 27 6 34 50 29 24 40 18 21 45 77 84 95 80 50 23 34 9 48 46 57 29 41 61 28 47 55 34 53 41 51 26 43 60 32 37 53 63 34
53 58 29 47 56 14 8 35 27 55 41 22 57 39 40 33 52 18 58 66 45 19 42 56 47 43 48 35 29 48 69 57 50 20 71 31 30 58 59 45 50 18 39 73 56 59 59 55 70 76 51 72 63 48 37 19 13 27 39 17 30 59 55 63 24 55 31 39 48 69 16 59 74 46 19 43 4 20 50 67 11 32 57 17 29 8 39 62 24 35 54 75 64 51 69 76 55 39 30
34 81 63 37 82 66 33 86 31 37 18 51 48 59 39 31 29 73 43 45 30 21 25 28 46 43 46 54 31 64 68 74 80 43 52 18 21 48 41 33 34 51 43 23 85 54 64 20 47 65 87 16 66 68 66 52 58 58 40 43 87 14 77 35 58 52 44 23 59 73 59 60 37 38 76 65 68 66 59 19 30 41 62 48 52 53 51 22 37 50 68 54 31 48 39 31 37 76 68
42 69 70 45 30 72 24 51 29 32 53 59 63 19 33 28 58 46 44 45 75 39 47 88 85 54 11 35 50 50 95 20 49 62 39 10 63 56 32 65 34 63 56 15 28 69 26 32 42 84 39 31 56 58 45 28 36 17 32 14 31 19 43 49 50 16 45 44 47 36 45 52 39 60 81 60 55 36 37 52 58 71 55 55 46 39 42 61 70 48 52 5 73 56 38 64 40 22 25
69 74 15 35 67 45 64 35 78 60 38 70 70 72 25 54 47 40 30 38 44 60 49 42 67 68 78 29 19 38 45 84 76 28 25 63 25 30 67 55 62 40 51 42 3 73 49 54 44 52 81 21 38 35 20 32 57 62 56 50 48 48 35 22 64 83 46 49 27 72 49 40 50 29 48 44 21 20 28 30 34 39 41 25 47 13 67 54 65 24 51 49 30 28 46 58 50 49 82
55 18 21 83 44 30 23 25 15 22 63 48 7 68 24 58 16 47 58 33 61 55 64 57 53 35 39 38 52 71 65 53 20 23 30 57 20 48 57 50 44 57 31 11 36 48 19 40 31 36 27 36 60 85 9 5 28 39 62 55 31 49 37 50 38 31 49 69 37 52 23 49 32 21 37 30 41 36 20 10 42 59 27 21 59 41 36 44 57 22 44 31 40 61 57 66 42 39 16
22 28 49 35 40 56 55 56 41 73 65 58 59 23 77 81 34 34 82 30 26 44 5 59 59 40 60 74 61 37 40 43 48 36 54 55 46 57 75 42 29 45 36 43 13 57 35 70 49 22 16 45 47 38 49 28 58 37 65 42 91 68 60 15 6 37 73 47 44 56 79 78 46 24 46 46 33 48 16 34 56 64 30 67 7 37 61 61 65 50 20 16 75 86 64 34 41 45 37
45 41 47 47 47 68 49 47 31 45 16 56 45 62 53 41 45 58 78 59 57 68 17 64 51 64 20 62 52 56 39 45 35 31 19 61 34 31 61 35 39 41 14 56 35 60 67 60 51 27 41 57 79 73 61 21 36 50 32 52 50 46 52 46 57 44 17 61 35 31 60 49 59 49 42 48 6 42 57 69 63 34 58 19 56 58 25 71 32 67 67 49 39 47 41 30 42 52 55
39 39 56 47 52 10 50 51 52 40 54 41 43 53 44 44 19 27 53 12 45 52 52 61 52 55 43 64 29 27 48 47 37 60 31 14 31 37 37 32 29 81 63 23 29 64 17 27 66 40 55 95 71 62 30 47 60 76 26 67 72 68 76 37 37 36 24 76 18 24 46 50 58 18 43 50 68 39 39 44 50 24 46 40 24 18 42 25 38 64 51 34 37 52 51 58 56 50 47
55 57 14 67 42 25 55 77 41 38 50 38 60 22 41 62 69 20 37 45 38 50 58 39 66 56 34 27 40 63 52 19 18 23 50 47 35 40 32 28 32 40 50 44 40 94 59 76 79 37 38 53 68 56 48 36 68 24 57 46 67 48 33 70 23 53 32 45 22 40 36 61 45 72 61 78 43 23 32 52 44 84 72 28 36 70 59 49 39 57 47 63 72 55 47 24 25 39 33
26 57 19 60 65 72 76 65 74 45 56 30 58 50 65 55 64 51 42 21 43 42 36 37 7 16 54 17 42 50 41 58 40 56 46 56 40 27 48 38 39 62 46 18 33 48 41 69 75 51 34 36 65 63 38 51 23 61 40 38 48 57 47 45 64 54 51 18 25 41 34 37 36 22 43 55 61 59 24 51 32 51 62 42 64 46 66 82 70 38 3 40 3 11 37 65 40 55 21
33 68 30 26 34 42 71 78 60 32 49 32 44 46 87 63 52 46 43 16 65 56 14 45 63 58 46 47 66 44 59 60 39 33 48 42 51 43 34 31 50 46 37 41 51 55 47 21 13 72 52 42 58 52 75 44 47 42 56 23 56 57 18 72 33 45 16 23 54 47 33 32 61 21 59 57 53 49 65 36 39 27 41 62 44 36 39 54 83 67 65 65 32 34 76 40 48 27 33
42 38 75 79 77 62 58 24 34 61 73 45 43 28 35 72 54 40 42 58 77 61 46 42 55 49 37 57 49 55 70 51 78 34 26 36 48 18 33 51 32 51 48 52 49 51 43 49 74 48 47 46 26 39 25 59 33 65 25 59 68 60 58 38 58 70 32 29 54 57 60 59 42 34 55 28 53 22 41 34 56 26 34 65 81 77 54 64 57 26 35 20 62 68 50 42 51 57 41
42 42 40 67 54 31 33 13 21 12 16 46 63 43 41 30 65 67 36 54 22 57 47 21 41 41 58 61 57 62 33 44 64 22 30 12 79 54 55 74 28 51 48 60 43 52 57 19 43 15 54 67 54 69 48 44 74 72 63 52 57 43 60 77 82 54 57 63 68 27 32 38 28 25 10 61 55 47 61 44 23 76 22 46 61 63 79 50 53 77 25 78 33 3 32 42 68 51 45
40 79 22 62 55 59 41 45 59 39 12 23 96 54 48 62 40 55 53 51 23 39 52 65 72 68 49 18 37 50 59 75 43 68 68 46 27 16 34 70 74 78 77 61 27 10 27 22 41 39 52 62 58 53 7 5 44 30 62 52 25 52 33 75 38 49 44 48 57 41 57 56 55 73 20 16 42 46 35 51 26 19 25 50 15 47 46 57 61 49 68 38 74 66 34 45 41 59 16
49 24 32 39 69 53 27 60 76 64 9 52 42 65 46 58 51 44 23 29 61 28 39 21 48 22 13 26 49 57 65 71 39 42 45 60 46 50 21 15 56 22 42 41 19 26 51 42 36 51 57 80 67 28 22 62 38 54 24 41 15 42 39 16 58 51 22 69 32 59 67 68 46 53 54 58 36 77 23 37 9 22 23 34 37 42 49 55 52 45 27 54 23 86 76 31 33 45 58
42 38 82 45 26 56 50 35 61 40 54 30 50 31 76 61 70 49 49 41 35 51 67 55 22 25 51 27 42 30 37 56 62 63 56 44 72 25 75 36 63 41 28 44 62 47 11 48 48 21 11 43 64 49 65 57 39 53 40 44 74 34 58 24 55 65 66 62 17 72 54 47 33 29 50 38 72 64 65 46 38 33 25 54 32 41 22 74 84 69 66 27 41 50 72 12 75 41 52
69 46 53 29 43 66 59 45 62 37 41 32 50 52 55 62 68 37 54 70 61 29 53 42 65 58 5 47 69 43 27 73 70 67 42 50 60 56 66 93 73 64 58 14 59 49 60 34 26 47 27 47 51 18 44 34 42 47 67 32 50 65 49 16 37 32 48 56 65 61 47 25 46 26 40 14 44 62 39 40 51 28 17 40 45 21 36 29 27 60 61 41 41 61 49 65 56 12 55
56 22 32 52 50 22 71 63 46 40 14 52 64 28 41 16 27 27 44 49 71 55 50 48 12 50 59 36 50 79 68 66 57 28 60 58 50 75 28 61 60 50 41 43 45 60 14 52 62 61 33 62 70 37 46 76 14 30 26 36 47 77 60 65 51 13 41 31 37 44 62 66 29 29 35 19 51 42 81 30 68 31 32 36 58 38 61 42 44 73 58 71 74 39 34 45 47 29 28
22 53 77 27 46 39 73 31 87 85 59 30 26 51 77 40 70 50 40 15 24 22 29 47 73 43 70 40 25 53 67 59 66 58 36 37 32 54 40 46 44 47 34 62 39 57 61 64 60 26 61 67 47 53 73 48 65 58 76 49 68 46 81 55 56 60 19 42 31 35 35 49 65 80 51 48 59 14 58 60 20 51 56 70 46 31 40 26 30 68 9 35 55 52 29 67 67 33 42
27 44 49 28 40 21 52 31 35 16 21 74 20 53 62 64 38 14 51 24 48 17 31 47 60 30 66 21 28 39 40 84 33 54 40 20 39 28 65 29 41 41 32 43 16 44 69 65 60 71 68 73 64 44 47 81 39 38 22 33 63 52 53 59 68 57 63 49 49 52 61 61 37 32 38 19 16 34 40 62 38 40 59 53 91 54 32 21 37 51 65 35 66 39 10 42 24 55 42
48 23 51 62 54 42 53 52 27 26 15 35 63 45 36 49 39 72 71 41 26 13 74 58 65 63 41 33 20 64 30 48 46 42 20 24 33 68 41 47 11 60 64 51 27 23 58 60 46 86 77 61 61 44 57 64 63 25 41 41 28 60 31 28 78 70 67 71 38 40 65 33 47 78 85 26 58 38 34 46 62 47 25 53 60 38 37 34 18 46 63 44 55 32 44 62 47 82 43
53 61 67 54 43 34 30 46 46 23 73 40 68 62 59 30 94 62 41 55 45 53 34 58 39 32 59 73 18 57 54 52 36 31 17 42 76 23 30 25 51 77 40 34 49 30 14 41 62 53 61 36 36 79 80 54 54 82 51 90 89 40 74 60 41 40 43 38 46 34 57 72 83 55 44 26 82 18 52 25 52 57 66 61 41 63 37 61 23 42 59 58 28 50 55 38 43 29 46
61 18 80 41 56 59 72 68 30 24 68 11 32 19 33 30 34 10 18 64 46 63 67 55 22 58 31 30 74 28 59 58 53 17 42 45 30 38 46 30 50 69 57 47 38 43 63 36 51 32 67 88 63 52 68 57 64 34 50 63 64 49 52 61 45 30 29 18 24 22 16 29 47 33 20 56 37 46 31 24 59 52 26 72 54 65 59 73 78 79 73 75 45 51 31 17 11 36 37
26 24 44 48 53 37 76 59 56 34 21 34 53 31 60 64 47 81 51 41 66 39 15 21 47 31 38 23 58 58 61 36 35 59 63 64 68 14 58 44 38 51 53 47 41 45 15 35 16 47 46 88 45 34 36 25 31 17 36 42 57 74 59 51 46 17 34 41 61 70 15 47 42 26 57 51 62 58 30 44 24 31 49 77 61 58 50 22 47 35 53 52 16 56 56 27 49 7 15
23 64 32 36 25 72 50 56 56 56 58 8 22 63 37 50 28 58 29 44 22 7 41 16 21 48 22 71 56 61 58 72 54 35 30 37 69 18 15 41 49 53 27 59 28 54 45 38 14 44 52 55 33 29 54 45 65 30 49 65 60 77 35 48 37 24 54 71 49 40 37 34 89 50 46 26 10 22 49 59 54 69 75 35 46 46 39 53 56 65 70 44 59 54 40 52 61 47 20
35 85 43 48 66 63 67 64 54 48 23 65 61 57 49 18 55 30 38 44 30 69 44 41 65 69 43 38 56 53 56 73 28 39 38 39 36 12 62 64 65 52 21 64 45 62 23 10 30 45 63 59 24 75 28 52 56 92 35 84 48 37 58 68 21 28 34 70 56 19 31 15 44 51 47 32 52 45 54 63 45 40 44 63 61 47 23 42 52 44 31 47 51 39 37 69 79 41 31
69 27 35 34 76 58 20 18 34 20 45 53 43 40 59 33 31 60 63 45 36 21 34 54 61 41 58 70 47 24 50 53 31 36 70 51 50 45 60 28 13 58 64 34 21 41 42 40 35 36 49 35 43 24 41 26 41 18 48 52 35 50 23 31 26 41 62 43 34 52 80 61 14 18 94 73 48 87 64 55 49 30 31 65 76 55 60 47 59 62 52 48 46 53 18 51 24 42 52
34 34 60 44 36 64 80 84 57 43 21 50 34 52 58 45 62 73 42 50 59 80 56 65 67 54 27 81 39 45 65 17 59 31 53 54 33 74 42 42 39 68 56 60 63 15 56 50 69 78 29 27 35 73 17 69 92 72 51 39 74 60 37 58 78 45 44 66 53 42 42 12 59 54 42 63 24 29 32 29 51 67 17 55 43 18 69 44 9 22 8 39 75 36 79 79 73 25 41
86 25 34 54 57 59 49 70 63 54 62 78 68 65 35 48 44 72 34 51 62 19 66 34 33 24 17 70 70 44 59 38 63 60 39 38 50 41 38 32 27 58 92 35 57 65 26 13 62 36 37 31 58 71 55 47 64 33 44 53 48 42 38 33 75 76 49 48 20 61 18 33 44 59 31 45 60 60 75 77 49 62 50 60 53 52 39 57 20 40 58 90 28 10 64 47 58 69 22
29 54 40 33 53 65 56 36 31 49 53 27 55 44 44 59 59 28 48 51 52 55 27 28 83 78 80 44 48 52 40 27 39 72 64 56 34 32 58 44 44 65 5 34 34 45 61 27 22 52 50 37 36 44 52 48 19 60 35 62 43 58 74 59 33 63 37 25 59 58 54 62 57 30 26 57 45 29 41 60 72 28 28 38 13 18 15 34 31 65 39 41 41 43 88 13 34 15 41
26 47 73 75 96 71 64 35 82 65 67 45 61 34 16 35 46 13 21 81 40 62 45 25 21 76 50 79 11 39 79 25 37 64 45 75 20 40 66 20 17 2 29 40 37 55 64 64 59 30 43 55 52 71 75 68 76 88 45 55 44 23 21 67 48 35 31 10 29 28 48 56 32 44 21 65 54 27 42 58 67 38 23 29 57 54 49 46 47 48 56 28 29 54 44 44 58 35 63
61 76 77 11 67 63 58 49 48 61 73 72 67 59 38 66 66 43 25 44 23 51 49 51 63 39 19 65 47 54 62 40 57 25 40 30 33 20 23 33 56 85 50 39 42 55 39 15 58 56 56 45 33 16 41 37 52 76 28 52 39 71 69 75 27 57 27 17 18 25 44 66 61 60 82 19 18 34 33 43 38 42 17 34 15 35 36 56 50 33 4 53 81 55 56 32 24 67 73
16 25 64 21 32 43 52 39 63 52 37 44 57 52 13 19 6 60 71 58 43 37 57 36 43 66 24 17 70 61 51 12 21 30 36 52 43 57 44 59 58 14 33 61 71 77 70 85 48 65 62 45 34 45 36 42 61 39 73 60 18 15 63 25 50 72 52 65 31 43 51 43 38 33 51 69 43 63 44 42 33 71 49 50 44 15 64 29 64 63 57 33 9 51 67 70 40 15 47
73 48 25 73 75 61 11 59 16 72 46 25 37 60 22 17 33 55 73 38 27 38 69 43 71 35 57 54 66 70 59 20 70 68 86 40 57 26 25 57 25 40 63 9 42 51 53 34 32 52 65 39 29 55 39 32 44 64 36 52 53 53 74 100 70 32 43 28 53 54 46 41 15 51 42 48 19 50 75 51 46 85 62 48 24 50 64 24 33 44 32 41 17 51 32 50 46 55 45
59 36 44 27 38 38 29 45 5 71 78 53 37 22 20 62 52 35 81 34 44 50 78 49 33 37 40 64 17 29 58 41 33 24 35 57 53 81 15 39 80 58 39 59 75 46 33 16 8 24 68 34 47 34 37 35 37 42 56 36 36 64 39 50 73 70 13 71 83 67 36 34 36 36 50 55 64 55 31 12 45 40 33 79 60 47 57 30 44 44 73 25 25 63 77 40 62 51 46
63 67 74 71 67 32 35 56 17 26 37 19 67 70 106 63 56 46 29 63 39 31 51 59 15 63 4 75 70 14 51 35 54 50 39 53 61 52 46 35 27 39 27 51 41 51 66 51 61 68 34 57 31 24 30 40 29 38 60 72 32 59 47 76 40 39 45 43 49 50 46 64 47 39 47 41 31 62 63 53 43 68 71 57 36 34 61 50 51 65 35 43 54 28 41 49 53 31 29
51 44 77 51 23 63 34 67 53 55 18 38 32 39 41 49 63 79 49 33 46 31 46 56 30 36 17 44 46 36 23 48 59 42 45 50 42 33 27 46 21 50 9 29 44 56 59 83 69 42 25 54 26 43 84 48 76 26 29 46 68 26 58 53 54 19 32 84 39 30 40 66 23 20 64 71 72 61 44 21 39 35 47 54 40 47 61 37 29 22 45 44 31 73 46 61 61 22 39
25 67 28 23 12 25 64 42 50 37 32 43 33 50 35 23 50 52 47 43 60 42 16 44 33 43 14 50 32 17 35 24 47 31 51 49 22 36 52 28 52 54 47 30 44 55 64 38 30 11 42 68 72 47 59 59 62 33 17 27 25 52 80 67 44 43 69 25 16 30 63 65 58 65 71 46 15 45 27 23 45 24 68 22 60 66 58 14 63 46 29 69 71 52 22 19 40 47 26
12 60 23 22 34 29 31 63 28 62 47 27 29 60 70 52 10 30 35 68 40 56 46 56 65 38 35 36 78 48 52 50 40 31 37 23 30 75 69 32 31 35 69 44 55 75 76 18 37 71 73 14 14 16 35 65 36 47 50 26 27 45 54 38 46 63 68 65 53 60 68 66 77 58 52 56 27 44 45 44 25 34 25 70 61 50 26 28 43 61 57 54 34 63 37 65 57 26 17
51 54 70 36 28 42 32 21 53 77 38 25 40 51 34 31 28 39 32 51 47 46 42 38 35 69 70 81 66 46 46 59 40 58 68 51 26 47 54 34 47 44 30 39 55 54 21 53 63 31 41 52 38 90 70 45 46 36 27 40 32 59 53 27 49 63 14 23 23 59 55 32 48 70 71 43 65 66 37 61 44 44 78 29 68 57 65 49 23 39 48 54 36 51 46 31 44 58 23
61 30 33 46 57 7 65 35 27 42 54 24 68 58 43 32 71 66 18 68 21 39 45 70 39 28 17 31 38 76 39 68 70 50 56 58 53 16 33 33 57 70 85 62 67 80 42 46 18 16 27 52 26 77 69 39 51 38 31 64 34 7 54 84 26 15 31 52 21 63 56 51 75 53 17 23 31 57 68 50 36 38 38 64 26 52 77 15 69 64 21 52 54 37 23 48 26 43 56
5 33 51 49 50 62 40 16 52 33 48 26 37 44 60 54 80 61 36 45 56 61 44 41 53 43 47 24 83 59 49 23 34 52 53 64 51 60 15 54 41 42 8 11 46 40 61 57 48 31 44 59 76 60 42 55 74 69 67 51 35 55 36 55 23 52 25 44 19 30 23 38 76 43 52 37 37 48 25 34 62 33 34 62 37 41 28 37 33 16 63 63 50 33 25 57 91 67 42
35 42 66 44 24 37 67 22 42 40 61 48 55 67 75 28 57 31 41 42 15 45 57 75 24 52 60 65 31 51 45 8 47 25 33 47 51 57 50 46 58 55 73 59 14 9 18 50 67 47 41 36 62 52 47 29 67 35 48 49 59 65 63 24 25 45 41 26 22 29 56 61 15 36 55 48 41 61 25 64 30 34 42 58 33 41 67 76 50 52 40 62 54 53 35 22 32 44 41
31 54 46 31 33 29 55 72 73 37 42 15 63 31 25 19 69 52 38 47 60 60 53 36 55 63 32 19 33 77 43 35 30 40 23 13 25 64 30 51 47 50 62 22 24 70 53 41 47 37 60 51 55 54 79 68 34 56 18 41 30 20 52 46 41 24 27 12 14 26 23 54 43 59 12 63 74 64 47 43 41 17 32 24 29 7 70 65 52 54 24 37 40 17 75 64 46 44 22
40 66 27 41 52 42 41 61 56 60 54 55 63 68 12 53 56 85 36 40 41 20 42 77 10 42 4 65 42 69 66 73 34 28 41 22 47 41 57 50 78 39 14 34 47 41 29 45 68 69 61 24 36 47 78 79 58 48 36 35 58 34 48 4 49 33 63 77 63 44 46 23 62 48 47 48 44 29 41 31 46 43 36 30 35 37 59 66 9 32 64 64 35 45 9 44 56 24 62
35 41 71 58 32 34 39 37 23 58 46 44 46 47 52 87 53 3 62 53 63 82 56 63 47 58 54 72 35 36 85 55 49 14 26 91 46 55 74 16 15 51 50 46 54 35 55 82 48 42 47 26 29 43 52 13 76 31 66 36 69 51 49 47 36 12 49 18 63 55 47 37 47 33 70 33 51 61 34 56 60 37 61 49 31 46 42 29 56 20 77 65 50 42 49 83 29 47 52
56 36 50 50 55 8 62 32 32 33 38 42 51 25 49 62 39 14 40 51 43 51 41 36 37 47 52 49 62 33 77 31 68 55 53 24 34 60 51 49 65 52 83 61 31 1 27 41 29 34 68 62 59 32 52 53 44 50 22 73 17 58 44 17 44 33 54 48 58 31 64 17 55 21 48 57 46 27 53 35 63 65 49 54 16 77 45 41 38 52 13 70 33 52 32 50 57 41 55
80 66 39 36 56 67 66 61 24 73 27 36 16 47 26 69 55 59 84 63 44 80 18 60 60 39 57 29 62 54 44 58 58 39 72 20 68 56 69 44 46 45 10 41 61 41 42 26 55 17 41 50 62 63 39 24 15 63 47 45 3 19 53 42 39 29 43 71 30 9 49 51 39 23 54 52 59 21 52 48 66 29 64 57 54 20 48 72 72 52 60 58 31 84 32 37 45 20 33
60 59 54 50 55 57 51 54 33 70 48 33 39 49 72 61 14 85 52 56 69 47 56 74 32 50 37 50 60 51 29 71 25 63 51 59 26 71 45 31 68 72 62 62 16 34 46 14 39 48 53 39 44 57 46 24 80 47 58 33 50 43 61 21 54 34 64 57 28 40 72 35 54 64 59 50 82 73 21 25 58 71 65 29 45 36 48 63 70 48 58 24 23 54 54 66 64 44 37
41 66 70 55 75 84 48 38 25 22 48 23 45 70 45 27 31 54 47 48 36 32 53 52 26 2 25 58 41 67 72 83 65 53 10 43 34 36 21 65 62 60 50 68 49 48 36 35 55 37 14 73 57 57 35 57 51 45 46 48 72 47 51 33 27 45 56 62 52 26 85 34 49 16 74 34 49 59 37 15 20 49 64 56 38 33 22 29 29 26 67 71 39 38 23 39 33 56 50
26 74 32 20 20 69 33 63 43 49 51 41 36 46 43 61 51 76 83 94 47 31 76 25 63 26 22 62 59 39 55 49 26 33 53 28 45 56 60 31 47 31 46 43 43 49 62 32 45 62 29 42 33 63 57 42 48 36 35 35 71 54 87 81 20 29 28 48 35 66 46 58 57 56 75 40 66 68 70 74 51 33 49 50 28 78 85 81 19 44 46 26 67 52 36 64 58 14 87
36 42 44 52 51 41 15 48 72 44 52 78 8 49 25 44 64 29 55 44 61 54 67 61 61 28 14 61 65 39 62 65 63 32 52 66 51 18 64 40 71 65 47 16 54 58 61 41 40 26 45 52 87 49 40 40 46 41 67 28 44 51 73 59 26 38 34 38 56 44 50 69 61 66 30 29 54 24 47 27 44 50 82 57 49 66 78 48 22 71 68 51 9 24 10 72 68 43 38
35 10 49 43 82 53 32 58 26 15 37 57 70 15 64 30 61 43 38 56 37 69 73 57 83 51 55 63 45 31 70 64 37 38 67 23 56 55 67 36 57 74 68 23 61 66 31 62 42 74 56 19 25 63 59 55 77 21 54 66 42 34 28 37 57 35 59 43 59 41 66 65 10 23 61 21 18 48 8 24 61 52 77 64 50 43 15 41 25 68 72 57 74 83 48 45 64 34 44
45 37 49 56 7 70 59 68 71 37 50 63 56 40 60 75 52 29 42 32 47 66 55 8 54 31 83 72 50 12 50 60 48 33 56 57 37 16 55 50 34 45 50 62 28 27 20 48 54 59 73 34 21 31 45 47 25 24 71 72 20 39 42 67 61 49 27 36 39 66 38 54 65 55 29 49 34 78 59 27 42 70 44 52 40 41 40 34 74 42 26 24 37 28 35 49 51 37 31
53 53 15 18 46 43 64 69 54 36 56 31 32 49 52 23 52 43 71 44 43 38 60 32 61 9 51 34 28 71 45 24 56 68 23 52 47 39 29 36 51 43 40 71 79 57 17 34 59 52 36 43 56 62 54 57 68 62 48 62 35 28 92 54 66 39 60 48 82 59 17 57 54 80 42 42 25 37 22 35 46 21 59 21 60 47 59 50 40 23 34 67 44 64 55 17 18 21 36
57 38 81 30 38 49 48 31 32 44 17 79 76 32 35 49 23 58 58 14 64 72 45 23 52 74 61 8 57 35 44 34 37 10 58 39 43 24 38 39 50 17 46 46 38 51 46 68 37 69 42 38 35 54 52 83 51 56 44 46 76 58 36 25 50 38 66 45 39 53 47 57 21 15 47 57 39 72 49 48 29 71 64 24 41 46 62 64 53 53 29 57 65 16 33 63 15 76 68
34 37 58 49 38 75 57 64 49 41 34 57 45 48 36 24 32 42 35 41 72 71 19 6 28 51 56 39 64 66 67 75 52 56 53 64 56 52 69 51 27 63 52 57 46 62 59 59 31 52 39 53 63 75 64 31 27 39 24 60 54 44 10 43 25 44 45 35 35 29 52 46 54 28 57 42 47 50 60 10 42 18 39 85 56 32 39 42 58 54 58 58 33 33 61 52 78 58 70
45 57 61 66 4 56 48 35 24 24 33 33 46 41 49 31 50 37 25 75 33 49 43 21 25 56 66 43 34 16 56 59 37 46 55 20 60 33 78 36 22 26 34 81 79 57 64 52 31 65 50 50 11 63 31 64 17 28 58 52 22 60 84 87 32 64 13 33 56 74 55 40 28 47 48 59 32 59 58 21 53 61 54 57 28 41 71 66 43 33 21 59 34 71 71 23 48 19 65
30 47 64 32 44 41 35 65 52 55 81 64 23 55 43 15 56 50 54 30 53 38 53 38 41 39 42 39 46 32 71 62 48 52 37 53 14 53 50 31 56 27 50 36 25 47 44 25 48 54 19 23 57 72 46 65 24 46 52 71 24 22 26 43 48 58 69 66 17 28 64 34 15 65 32 80 29 25 24 25 36 35 36 28 51 71 30 49 45 22 6 75 46 80 56 15 33 37 56
56 41 26 29 41 51 50 59 68 88 62 74 71 57 42 28 32 47 16 30 24 38 53 56 40 48 28 82 68 51 61 42 19 71 13 47 5 57 65 78 72 65 31 45 24 50 34 69 56 72 40 28 44 44 36 27 33 34 65 61 59 27 43 45 34 34 71 66 43 61 52 89 81 44 29 52 62 37 32 57 56 56 33 5 15 44 64 20 31 24 22 19 33 54 56 76 42 27 56
50 64 48 48 40 37 50 33 34 51 91 93 46 12 31 61 63 30 29 36 10 23 35 16 53 36 45 43 45 61 13 38 44 56 21 33 55 37 53 55 57 40 14 27 17 29 55 43 39 42 52 39 55 71 47 24 28 54 39 48 57 57 62 16 59 38 12 47 32 52 47 60 56 42 34 84 29 42 10 52 70 44 54 25 24 48 47 26 67 45 15 33 30 32 18 41 25 49 67
87 57 47 31 14 36 73 63 64 37 68 35 53 21 59 66 39 15 68 63 45 63 38 59 41 46 62 37 30 13 32 24 28 50 31 51 64 65 41 59 73 68 45 52 56 69 71 42 46 54 11 38 28 36 40 11 36 58 86 68 22 24 41 36 64 56 20 71 62 41 45 78 51 46 17 23 56 68 46 25 50 58 47 26 63 42 59 54 70 23 63 33 40 35 51 23 64 29 21
62 40 11 19 41 69 31 48 58 46 39 66 41 48 39 45 41 48 31 64 35 15 41 39 47 67 48 18 17 77 59 63 42 35 26 64 43 39 46 21 49 59 53 36 37 17 56 41 56 55 71 62 57 36 29 19 61 18 30 56 42 24 17 50 63 34 54 54 40 41 30 33 34 50 29 40 46 73 76 62 20 67 60 51 60 65 68 43 40 33 60 15 38 27 51 39 52 21 45
21 64 60 6 64 35 35 36 60 62 64 18 54 53 9 43 48 29 49 31 77 28 51 35 51 63 73 47 50 55 61 53 29 29 45 21 46 56 62 9 40 48 47 67 60 76 66 62 31 48 33 44 51 43 41 20 51 39 24 68 41 53 53 57 33 52 55 26 40 31 57 43 72 49 37 58 15 76 41 36 39 22 61 24 62 38 42 65 44 63 51 55 16 39 51 10 33 46 63
58 39 40 41 51 36 36 64 18 66 47 42 34 36 37 44 35 14 67 32 39 43 25 53 52 52 49 34 53 53 42 64 61 24 31 16 31 52 82 95 7 73 63 36 16 43 41 26 25 84 61 37 35 44 62 9 46 48 47 24 64 24 62 74 52 30 46 69 55 20 42 54 74 53 26 37 71 28 56 17 11 33 51 53 37 72 64 53 48 9 25 46 25 38 49 57 64 31 38
49 43 24 36 68 29 15 55 29 47 51 60 65 38 55 17 51 49 45 78 58 51 70 66 49 45 72 50 33 42 38 22 51 12 31 68 42 18 42 55 73 50 72 20 47 56 78 67 61 58 69 75 45 53 62 15 35 32 41 45 33 46 50 22 63 82 53 48 60 52 58 74 48 45 44 58 36 31 72 31 36 37 45 62 67 72 46 50 50 46 24 28 56 36 14 48 38 21 35
32 36 66 73 39 42 45 45 36 43 37 48 52 32 33 38 52 60 56 35 70 32 30 9 42 19 47 61 57 15 32 13 33 29 82 7 25 53 33 28 11 27 24 33 33 16 29 37 19 34 33 65 64 64 80 62 49 38 20 39 58 32 76 47 48 44 58 38 32 33 40 59 29 43 45 42 44 50 49 35 23 64 22 38 59 58 13 79 59 10 48 68 64 79 72 43 38 38 62
21 73 42 15 30 23 62 36 47 30 47 13 37 57 49 24 22 60 64 73 27 25 24 40 30 29 76 17 54 44 59 46 47 72 75 36 29 34 49 58 70 76 60 23 51 60 67 41 74 65 59 47 35 41 39 55 50 42 70 68 46 44 45 40 52 39 42 16 18 48 40 53 54 49 44 28 55 53 10 38 34 25 68 60 30 57 29 78 57 31 40 48 24 43 53 36 54 28 42
47 58 54 22 28 19 13 44 58 47 49 22 41 65 35 64 42 33 53 32 43 58 22 37 17 55 39 81 38 19 25 14 42 47 48 22 33 34 55 60 49 42 41 55 58 34 36 80 25 58 45 46 42 50 57 38 28 78 50 50 44 49 50 57 52 39 22 71 69 47 30 57 53 41 45 32 67 76 41 41 56 43 36 38 48 52 42 69 36 42 76 31 43 27 42 71 27 35 26
30 68 47 31 21 66 26 27 51 37 34 53 42 61 87 78 38 21 38 67 53 34 69 13 58 93 52 56 29 81 84 64 30 23 52 82 58 57 40 42 85 76 50 88 65 61 15 54 53 19 43 55 33 56 71 39 64 41 59 29 69 32 63 50 13 64 76 54 47 79 47 21 44 60 27 46 11 54 50 24 87 40 66 19 55 71 50 53 60 32 33 34 38 28 46 63 27 66 31
45 56 51 50 44 59 38 45 31 40 62 81 64 71 29 43 35 53 28 63 48 31 84 72 59 17 53 59 74 55 44 7 67 45 69 65 79 41 50 30 70 35 37 54 38 54 64 53 33 73 55 63 62 46 48 41 42 67 85 71 39 60 40 25 47 66 50 31 47 42 40 61 48 34 23 46 26 44 84 20 57 55 52 30 42 48 70 30 40 86 54 37 35 52 33 21 48 35 50
71 36 43 48 40 32 61 61 26 36 30 60 45 10 41 24 56 59 48 56 46 23 41 52 69 42 74 55 40 58 32 34 33 43 77 89 47 50 26 44 43 42 61 40 74 50 38 49 58 7 69 31 7 48 36 47 38 42 67 57 61 30 62 57 66 37 49 76 41 47 38 23 16 49 44 32 19 12 19 36 30 48 58 33 67 49 39 47 73 75 38 17 7 22 51 52 17 51 36
79 47 61 39 28 56 78 66 51 67 53 39 39 34 84 55 13 31 38 57 70 65 67 13 58 47 51 18 42 72 69 36 51 58 36 45 43 39 37 58 78 50 40 25 69 54 24 37 35 62 51 41 43 52 50 83 74 52 53 42 78 57 71 36 55 55 50 23 62 40 47 17 63 59 55 61 43 53 59 59 51 44 15 66 43 18 46 43 54 18 59 47 53 19 82 68 44 48 28
29 22 21 63 69 30 45 29 31 27 45 14 27 73 58 70 11 19 52 45 43 8 38 47 16 12 43 40 58 59 24 33 57 64 30 24 32 64 24 21 37 56 76 79 21 55 34 54 12 66 28 26 60 36 40 37 55 17 22 60 27 65 19 54 69 93 64 64 35 45 68 62 32 51 43 78 21 69 70 19 29 54 41 62 61 37 39 29 41 66 78 21 58 31 57 27 46 25 37
81 13 22 22 29 47 45 49 78 44 17 62 52 57 46 10 42 62 55 58 17 28 53 45 59 59 34 36 27 21 55 58 83 22 70 67 51 35 61 24 33 25 42 23 20 39 12 74 49 68 50 35 50 54 37 17 36 51 38 47 77 54 15 41 63 63 25 23 47 44 48 16 38 60 36 41 42 21 51 55 59 53 48 64 78 43 58 47 30 55 16 32 63 59 8 58 12 23 54
36 37 53 48 42 87 68 32 18 35 50 24 35 16 69 58 38 57 50 55 35 80 85 18 66 34 27 40 44 32 46 40 43 38 50 68 34 45 34 56 9 19 40 63 77 59 63 49 47 48 46 29 44 13 22 46 73 20 32 33 43 48 38 56 47 39 48 20 42 45 43 38 39 32 38 56 50 55 57 45 64 48 31 70 68 31 62 50 77 57 64 19 53 51 50 45 28 50 68
54 65 39 79 17 31 32 23 51 32 29 39 25 34 54 78 19 49 46 30 53 65 48 37 76 38 40 42 42 21 78 69 57 39 27 12 23 33 31 55 65 59 64 22 48 54 26 55 33 47 60 79 77 61 86 78 45 33 23 26 33 76 65 65 55 33 45 59 39 53 42 67 87 56 39 12 53 40 50 45 59 63 83 58 40 46 57 21 57 47 26 52 15 30 43 53 69 66 62
18 22 56 35 36 31 41 36 23 58 24 45 68 41 31 37 54 52 66 51 62 45 52 58 21 60 60 50 19 70 24 64 14 14 14 61 38 71 43 37 66 75 56 84 27 67 57 29 38 56 39 79 43 46 36 29 54 38 41 53 66 59 57 55 48 57 30 11 29 58 17 57 58 27 54 32 22 63 44 56 63 32 40 27 11 31 61 40 35 5 47 37 39 50 24 58 49 31 34
39 32 65 67 27 27 74 63 34 41 44 40 73 67 66 60 30 16 71 69 20 60 41 74 73 21 52 36 37 54 94 77 28 47 67 43 20 74 62 56 45 59 55 69 63 57 17 55 39 54 82 72 34 65 40 49 22 30 45 79 63 38 42 40 43 67 58 44 31 40 63 16 10 55 60 58 21 19 19 38 55 63 95 65 35 68 47 68 64 59 66 76 38 46 59 58 49 24 66
