54 34 33 47 27 18 18 33 29 17 24 31 33 49 17 11 22 43 58
22 15 41 19 39 27 11 29 63 69 49 93 44 42 20 17 15 45 9
59 9 85 30 39 47 7 47 21 35 57 11 39 22 35 21 53 63 29
30 22 26 5 49 45 48 25 37 41 23 31 39 18 35 23 43 45 11
9 58 45 77 9 14 27 55 51 33 49 55 67 34 25 55 36 21 22
33 25 29 23 31 22 38 30 13 41 63 47 63 43 31 23 27 24 33
72 61 77 31 27 21 29 35 61 15 51 3 21 74 28 5 33 57 19
26 36 58 60 23 69 62 59 54 49 47 27 11 21 35 14 27 11 42
51 53 66 21 63 71 63 44 45 21 27 15 57 43 31 15 27 21 54
33 49 66 27 57 30 57 31 57 21 25 15 27 43 23 67 9 25 15
21 13 39 32 33 85 77 46 30 27 31 17 33 26 30 50 23 61 53
27 27 7 45 7 50 47 47 27 27 44 36 51 33 25 33 37 34 49
33 34 5 42 41 41 31 81 36 66 35 39 63 41 7 27 37 34 65
23 51 25 61 49 25 18 17 27 55 31 23 26 53 37 49 49 55 31
63 34 54 67 3 31 53 45 33 27 15 42 31 54 57 35 35 54 28
31 43 21 75 51 51 19 22 31 6 13 42 24 69 21 47 67 45 33
14 53 33 33 73 21 15 45 34 17 46 9 54 11 11 39 18 43 7
41 45 75 17 27 53 17 44 41 37 24 29 42 53 35 41 25 77 38
27 33 21 5 55 31 18 61 41 17 27 9 9 29 59 39 39 12 46
26 9 71 81 57 51 37 30 51 27 41 67 19 72 18 51 35 53 63
